Captain Taint = Capitaine Fétide (a changer partout)
Haunted Crotch = 

Killer Rabbit = Lapinsassin
Alien Eyeball = Glob-o-culaire Alien
Big Momma Dragon = Grosse Dondon Dragon
Oil Monster = Bibenduile
Stealth Spider = Araignée Furtive
Holiday Cookie Man =
Dark Forest Ghoul = Goule Sombrebois
Healerbot = Soignobot
Rampaging Farm Robot = Robot Fermier Saccageur
Bearalope Sire Antlers = Seigneur Ourstilope Cervidé
Oil Monster = Pétro'Glaire
Big Oil Boss = Méga Pétro'Glaire
Rocky Path = Sentier Pierreux
Oil Monsters = Pétro'Glaire
Coal Monster = Charb'o'Monstre
Orque-Post = 
Dark Forest = Forêt Ténébreuse
Old-Timey Ants ) Fourmis Jadis
37.8 Liter Hat = Casque Anti-Soif

Gingerbread Wildman = Sauvage en Pain d'epice
Vicious Chicken = Poulet Vicieux
Vicious Beast = Bete Vicieuse
Exploding Chicken = Poulet Explosif
Free Range Chizard =
Bearalope Cub = Petit Ourstilope
Monstrous Chicken = Poulet Monstrueux
Baby Blinker = Bebe Clignoteur
Lazy Eyeball = Glob-o-culaire Fainéant
Swamp Donkey = Ane des Marais
Blinker = Clignoteur
Sabretooth Donkey = Ane aux Dents de Sabre
Eye Monster = Monstr'oeil
Spitting Chizard = Chizard Cracheur
Giant Turtle = Tortue Geante
Tentacle Monster = Monstre Tentacule
Pet Blinker = Compagnon Clignoteur
Spitting Chizard Sire = Seigneur Chizard Cracheur
Bearalope Mama = Maman Ourstilope
Bearalope Papa = Papa Ourstilope
Hairy Eyeball = Glob-o-culaire Touffu
Demon Ore Rock = Démon Miné'Roche
Giant Rock Monster = Monstre Rocheux Geant 
Greem = Greem
Greem Fighter = Combattant Greem 
Butterpig = Papillochon
Kangamoo = Kangameuh
Swarmer = Grouillant
SwarmerHead = Chef Grouillant
Ore Eating Imp = 
Porcupine = Porc-épic
Badgephant =  Blaireauphant
Temperate Greem Queen = Reine Frugal Greem
Roving Greem Queen = Reine Nomade Greem
Forest Greem Queen = Reine Forestière Greem
Minor Miner Demon = Mineur Grouillot Démon
Unicorns = Licornes
Greem Haunted Shaman = Chaman Possédé Greem
Orque Healer = Guérisseur Orc
Demon Overseer = Démon Surveillant
Major Miner Demon = Commandant Démon Mineur
Demon Overlord = Seigneur Démon
Dark Lord = Seigneur des Ténèbres
Oozing Goo = Goo Suintant
Oozing Slime = Slime Suintant
Oozing Creeper = Plante Grimpante Suintante
Swamp Goo = Goo des Marais
Lesser Spider Baby = Bébé Araignée Ordinaire
Minor Spiderling Swarm = Smurtz Araignée Ordinaire
Spiderling Swarm = Smurtz Araignée des Marais
Lesser Spider = Araignée Ordinaire
Lurker Ant = Fourmi Guetteuse
Lurker Ant Warrior = Fourmi Guetteuse Guerrière
Termite Worker = Termite Ouvrier
Freakin' Giant Spider = Araignée géante Bizarre
Stealth Spider = Araignée Furtive
Shambling Skeleton = Squelette Breloquant
Ambush Ghoul = Goule Enbusquée
Screamer = Hurleur
Summoned Ghost = Fantôme Invoqué
Dark Warrior = Guerrier Obscur
Mini Rock Monster = Mini Monstre Rocheux
Leprechaun Honcho = Patron Farfadet
Rabid Gnome = Gnome Enragé
Savage Unicorn Male = Mâle Licorne Sauvage
Bright Red Demon Imp Horns = Corne de Démon Diablotin Brillante Rouge
The Giving Tree = L'arbre Partageur
Demon Imps = Démon Diablotin
Flaming Skull = Crâne Ardent
Greem Tracker = Traqueur Greem
Greem Scout = Eclaireur Greem
Von Prong Reservist = Réserviste Von Prong
Von Prong Weekend Warrior = Guerrier d'Astreinte Von Prong
Filthy Chizard = Chizard Dégoûtant
Demon Imp = Démon Diablotin
Ore Eating Imp = Diablotin Croc-Minerai
Beady Eye Monster = Monstre Neunoeuil
POW Camp = Camp Bang
Fiery Skeleton Cowboy = Squelette de Cow-Boy Fougueux
Orque Paratrooper = Paratroupier Orc



The Cleaver of Cleaving = Le Couperet de Clivage
Thongolith of Justice = Stringolithe de Justice
Thongolith of Courage = Stringolithe du Courage
Bone Eating Ghoul = Os Mangeur de Goule (Goule Mangeuse D'Ossement)
Demonic Ore = Minerai Démoniaque
Thongolith instrument = Instrument Stringolithe
Demon Poop Hammer = Mart-o-Crotte
Wretched Village = Village Misérable
Thunder Stomp = Cogne Tonnerre
Super Thunderstomp Club = Super Bâton Cogne Tonnerre
Cleaver of Cleaving = Couperet de Clivage
Demon Poop Hammer = Mart-O-Crotte
Sandy Bravitor = Sandy Bravitude
Hammer Of Frozen Dooms = Marteau des Jugements Givrés
Fist Of Mega Bashing = Poing du Mega-Cogneur
Undeath Thunder = Tonnerre Mort-Vivant
Fire Cleaver = Couperet de Feu
Nature Stamping = Timbreur Nature

Mating Stone = Pierre de Rencontre
Haunted Forest Mating Stone = 
pips = 
sidekick (sous-fifre) = acolyte
Dirt fit for the Wretched = 